0000000000
0100000000
0202222220
0202000020
0222000020
0000000020
0022222220
0020000000
0022300000
0000000000