00000000000000000000
01222200000000022200
00000202220222020200
02222202020202020220
02000002020202020020
02000222020202020020
02000200022202022020
02000222000002002020
02000002000002202020
02222002022200202020
00002002020222202020
00002002020000002020
02222002022202222020
02000022000202000020
02222220000202022220
00000000022202020000
02222222220002022220
02000000000222000020
02222222222200032220
00000000000000000000