00000000000000000000
00000122222000000000
00000200242000000000
00002420002200000000
00000200024200000000
00022200002200000000
00020000000200000300
00022200002420000220
00000200000200000242
00002420022200000200
00000222220000000200
02220000220000000200
02022220020200000200
02000022022522200220
24200002000200202420
02000002000000200220
02000002222222202420
02220000000000000220
00022222222222222200
00000000000000000000
