00000000000000000000
01000022222002220030
02002020002002020020
02225220024202420020
00002000002002020020
00000000022022020020
02220222220020020020
02020200000242020020
02020202000020020020
02020225222020020020
02020002002020022020
02420000002020002020
02022222222022202020
02000000000000202020
02020020222220202420
02252252200020202020
00020020002220202420
00000000002000202020
00000000002222202220
00000000000000000000