00000000000000000000
00000000000000000000
02222222222222000000
02000000000002000000
02012222222202000000
02000002262202420000
02200002262202000000
02200002000202000000
07200002022202000000
02200242022262200000
02200002024202000000
02000002024222000000
02222222020022000000
00000020020027000000
00000020020022000000
02222272220022000000
02550000000020000000
02220022222222223000
02222220000000000000
00000000000000000000
