00000000000000000000
00000000000000000000
00000000000022222220
00000000000020000020
00100000002220000020
00200000002000000020
00200000002000000020
00200022222000000020
00222220000000022220
00000000000022220000
00000222200020000000
00000200200020000000
00000200222220000000
00000220000000000000
00000020000000000000
00000022000000000000
00000003000000000000
00000000000000000000
00000000000000000000
00000000000000000000