00000000000000000000
00000022222222222000
00000020000000022000
00000242000000020000
00000020002222220000
00000020002000000000
00000020002222220000
00000320000000020000
00000000000002220000
00000000000002000000
00222200000024200000
02200200000002000000
02002420000222000000
02000200000200000000
02000222200200000000
01000000200200000000
00000000222200000000
00000000000000000000
00000000000000000000
00000000000000000000