00000000000000000000
00000001000000020000
00000002000002252200
02220002000022020200
02020002222222002200
02020000002000002000
02022200202000022000
02000222522000020000
24200000200002220000
02020000000002000000
02252200000002000000
00020200000002222000
00000202220002002000
00000202020202002200
00000222022522000200
00000000000200000220
00000000000002020020
00000000003225252220
00000000000002020000
00000000000000000000
