00000000000000000000
00000000000000000000
00000000000000000000
00000000000000000000
00000000000230000000
00000000000200000000
00000002222222200000
00000002222222200000
00000002222222200000
00000002222222225000
00000002221222200000
00000002222222200000
00000002222222200000
00000000000000000000
00000000000000000000
00000000000000000000
00000000000000000000
00000000000000000000
00000000000000000000
00000000000000000000
