00000000000000000000
01222202222202222200
00020200020002000200
02220222222202020200
02020000000202022200
02022222220222020000
02000200000202022200
02220202222202020200
00020202000000020200
02222202222202220200
02000200020202000200
02022222220202200200
00000002000000200200
02222222022202200200
02020002020200200200
00022202020222222200
02000202020000000200
02222202222222222230
00000000000000000000
00000000000000000000
