00000000000000000000
00222522202000000000
00200200225300000000
02400002000000200000
00222225220222522200
00002202020200200200
02225522022420024200
02002202020222000200
02000002022002000200
02522202202202000100
00200200200202000000
00002420200202002000
00002420200202225220
00002420200200002020
00000200252200002020
00000200020002225220
00000200200024202000
00000222522002000000
00000000202222000000
00000000000000000000
