00000000000000000000
00000000000000000000
00000000122222222220
00000002000000000020
00032225222000000020
00000002002000000020
00000000002000020020
00000000002022222220
00000022002020020000
02222277222020000000
02000022000242000000
02000000000020000000
02020000000020000000
02252220000242000000
00020020000020000000
00000020000020000000
00000022222220000000
00000000000000000000
00000000000000000000
00000000000000000000